---------
w       s
-       -
-       -
-       -
-       -
-       -
-       -
----*----

SimpleWater

4 2
4 7
4 4
2 4