----s----
-       -
-     - -
-     - -
w     - -
-    -- -
- ----  -
-       -
-------*-

SimpleSushi

4 4
6 6
4 4
2 4

